# Test Case 10 (valid): Columns
# ---------------------------------------------------
NO ./assets/textures/north.xpm
SO ./assets/textures/south.xpm
WE ./assets/textures/west.xpm
EA ./assets/textures/east.xpm

F 220,100,0
C 225,30,0

111111111111
100000000001
101010101001
100000000001
101010101001
100000000001
10000N000001
111111111111
