# Test Case 23 (valid): Wide hall
# ---------------------------------------------------
NO ./assets/textures/wall_n.xpm
SO ./assets/textures/wall_s.xpm
WE ./assets/textures/wall_w.xpm
EA ./assets/textures/wall_e.xpm

F 220,100,0
C 225,30,0

1111111111111111111
10000000N0000000001
1111111111111111111
