# Test Case 20 (valid): Square
# ---------------------------------------------------
NO ./assets/textures/north.xpm
SO ./assets/textures/south.xpm
WE ./assets/textures/west.xpm
EA ./assets/textures/east.xpm

F 220,100,0
C 135,206,235

111111
100001
100001
100001
100N01
111111
