# Test Case 24 (valid): Zigzag
# ---------------------------------------------------
NO ./assets/textures/north.xpm
SO ./assets/textures/south.xpm
WE ./assets/textures/west.xpm
EA ./assets/textures/east.xpm

F 220,100,0
C 225,30,0

1111111111
1000000001
1111111001
1000000001
1001111111
1000000001
1111111001
10000N0001
1111111111
