# Test Case 17 (invalid): Color value out of range (>255)
# ---------------------------------------------------
NO ./assets/textures/north.xpm
SO ./assets/textures/south.xpm
WE ./assets/textures/west.xpm
EA ./assets/textures/east.xpm
F 300,0,0
C 0,0,0
11111
10N01
11111
