# Test Case 92 (invalid): Unclosed spaces top
# ---------------------------------------------------
NO ./assets/textures/wall_n.xpm
SO ./assets/textures/wall_s.xpm
WE ./assets/textures/wall_w.xpm
EA ./assets/textures/wall_e.xpm

F 220,100,0
C 225,30,0

1 1 1
10001
10N01
11111
