# Test Case 25 (invalid): Color invalid non-digit char
# ---------------------------------------------------
NO ./assets/textures/north.xpm
SO ./assets/textures/south.xpm
WE ./assets/textures/west.xpm
EA ./assets/textures/east.xpm
F 200,200,X
C 0,0,0
11111
10N01
11111
