# Test Case 47 (invalid): Color range 256
# ---------------------------------------------------
NO ./assets/textures/north.xpm
SO ./assets/textures/south.xpm
WE ./assets/textures/west.xpm
EA ./assets/textures/east.xpm

F 220,100,256
C 225,30,0

11111
10001
10N01
11111
