# Test Case 72 (invalid): Map ring
# ---------------------------------------------------
NO ./assets/textures/north.xpm
SO ./assets/textures/south.xpm
WE ./assets/textures/west.xpm
EA ./assets/textures/east.xpm
F 220,111,119
C 225,111,200

 11111111111111111111111111111111111111
1000000000000000000000000000000000000001
1000011111000000000000000000000000000001
10001     100000000000000000000000000001
10001     100000000000000000000000000001
10001     100000001010000000000000000001
1000011110000000001010000000000000000001
1000000000000000001N10010000000000000001
1000000000000000001110010000000000000001
1000000000000000000000000000000000000001
1000000000000000000000000000000000000001
1000000000000000000000000000000000000001
1000000000000000000000000000000000000001
1000000000000000000000000000000000000001
 11111111111111111111111111111111111111