# Test Case 65 (invalid): Map border not wall
# ---------------------------------------------------

NO ./assets/textures/north.xpm
SO ./assets/textures/south.xpm
WE ./assets/textures/west.xpm
EA ./assets/textures/east.xpm

F 220,111,119
C 225,111,200

 1111111 111111111111111111111111111111
1000000000000000000000000000000000000001
1000000000000000000000000000000000000001
1000000000000000000000000000000000000001
1000000000000000000000000000000000000001
1000000000000000001010000000000000000001
1000000000000000001010000000000000000001
1000000000000000001N10010000000000000001
1000000000000000001110010000000000000001
1000000000000000000000000000000000000001
1000000000000000000000000000000000000001
1000000000000000000000000000000000000001
1000000000000000000000000000000000000001
1000000000000000000000000000000000000001
 1111111111111111111111111 111111111111