# Test Case 44 (invalid): Zero touching void (hole in wall)
# ---------------------------------------------------
NO ./assets/textures/north.xpm
SO ./assets/textures/south.xpm
WE ./assets/textures/west.xpm
EA ./assets/textures/east.xpm
F 220,100,0
C 225,30,0
11111
10001
1 001
11111
