# Test Case 34 (invalid): Map not closed (Open left)
# ---------------------------------------------------
NO ./assets/textures/north.xpm
SO ./assets/textures/south.xpm
WE ./assets/textures/west.xpm
EA ./assets/textures/east.xpm
F 220,100,0
C 225,30,0
11111
00001
00N01
11111
