# Test Case 61 (invalid): Forbidden
# ---------------------------------------------------
NO ./assets/textures/north.xpm
SO ./assets/textures/south.xpm
WE ./assets/textures/west.xpm
EA ./assets/textures/east.xpm

F 18,53,25
C 153,204,255

111111111111
1         11
1          1
111111111111
10Z000000001
111111111111
11         1
111111111111
