# Test Case 57 (invalid): Color trailing comma
# ---------------------------------------------------
NO ./assets/textures/north.xpm
SO ./assets/textures/south.xpm
WE ./assets/textures/west.xpm
EA ./assets/textures/east.xpm

F 20,20,20
C 200,200,

11111
10001
10S01
10001
